9 20
********************
*     *            *
** ** ***** ** *****
*  *         * *   *
*  *    *    * * * *
*       *        * *
*************  **  *
*
********************
9 20
********************
*               *  *
** ******* ****** **
*  *    *    *     *
*  *          *  * *
*       *** * *  * *
**** **** ***** *  *
*               *
********************
5 10
******** *
*    * * *
**** * * *
*        *
**********
2 4
****
****
3 3
***
*
***